NO ./textures/greystone.xpm
SO ./textures/greystone.xpm
WE ./textures/greystone.xpm
EA ./textures/greystone.xpm


F 42,42,42,42
C 250,30,0

1111111111111111111111111
1000000000110000000000001
1011000001110000000000001
100100000000000000000000111111111
111111111011000001110000000000001
100000000011000001110111111111111
111101111111110111000000100011
1111011111111111101010010001
110000001101010111000000100011
10000000000000001100000010001
10000000000000001101010010001
11000001110101011111011110N0111
11110111 1110101 101111010001
11111111 1111111 111111111111
