NO ./textures/greystone.xpm
SO ./textures/greystone.xpm
WE ./textures/greystone.xpm
EA ./textures/greystone.xpm

F 220,210,185
C 196,156,63

11111111111111
10000000000001
10000000000001
10000001000001
10000000000E01
10000000000001
11111110111111
